11111111111111
10011101110001
11011101100111
11011100001101
11010110111111
11000110010011
11111110011001
10111110011011
10000000000111
11111111111111