1111111111
1100111111
1111100101
1000001101
1011100001
1001001001
1000011001
1111111111