1111111111
1100111011
1111100001
1000001101
1011100001
1111111111